20 20
GGGGGGGGGGGGGGGGGGGG
GRRRRRRRRRRRRRRRRRRG
GRRRGGRRRRRRRGGRRRRG
GRRRGGRRGGRRRGGRRRRG
GRRRGGRRGGRRRGGRRRRG
GRRRGGRRGGRRRGGRRRRG
GRRRGGRRRRRRRGGRRRRG
GGRRRRRRGGGRRRGGRRGG
GGRRRRRRGGGRRRGGRRGG
GGRRRRRRGGGRRRGGRRGG
GRRRRGRRRRRRRRRRRRRG
GGGGGGGGGRRRGGGRRRRG
GRRRRRRRRRRRRRRRRRRG
GRRGGGRRGRRRGGGRRRRG
GRRGGGRRGRRRGGGRRRRG
GRRGGGRRGRRRGGGRRRRG
GRRGGGRRGRRRGGGRRRRG
GRRGGGRRGRRRGGGRRRRG
GRRRRRRRRRRRRRRRRRRG
GGGGGGGGGGGGGGGGGGGG
